100
WWWBWWWBWWWBBWBWBBBW
BWBBWWBBWWWBBBBWWWWB
BBWBBBWBBWBBBWWWWWWB
BBWBWWBBBWBWWWWBWWBW
BWBWWWWBWWBWBBBWBBWB
BBWWBWBBWBBWWBWWWWWB
BWWBWWBBBWWWWWWBWWWB
BWBWBWWWWBWWBBBWWBBB
WBWWBWWWBBBBBWWWBWWB
BWWBBBWWWWBBBWBWBWBW
BWWWWWWBWWWWWWWBBWWB
WBBBWWBWWBBWWWBWWBBB
BWBBBWBBWBBBWWBBBWBW
WWBBBWBBBWBWWWWBWB
BWBBBWBBBWWWBWBWB
WWBBBBBBBWWWWBB
BWWBBWWBWBWBWWW
BWWWBBBBBBWWWWWW
BWBBWBWWBWWBBWBB
WBWWBBWWWBBBBB
WWBBBWBBBW
BBWWBBWWBWBBWBBW
WWBWWWBWBBWWWWWWB
WBWWWWWWWBWBBW
WBBBBBBBWWBBWBB
WBBBBWBBWWBBBBW
WBWWBBWWBBBBBWBB
WWWWBWWWBWBWB
WBBBWBWB
WWWWWBWWWWBBBWB
BWBBWWBWBBWWW
BBWWBBBBWW
WBWBWBWBWWBBBBBBW
BWBBWWWBBWWWBWW
WBWBBWBWWWWWWWWBW
BBWWWWBWWBBB
BBWBBBWBWWBBWWWB
BWWBWBBBWWW
WWBBBWBBBBWBBBW
BBBWWWWBWBWW
BBWWBWBBWWWWBB
BBWBWBWWWBBBBBB
BWBWBBWBBBWWBBW
BWBWWBBBWBBWWWB
WWWWBBBBBWBBWWBBW
BWBBWWWWBWBBBBBWBWWW
BBBBBWBBBWBBWBWBBBBB
BWWWBWBBWWWBWBBBBWW
WBBWWBWWWBBWWBWWBBBW
BWWBBBWWWBBBWBWWBWWW
BBWBWBBBBWBBWBBBBBWB
BWWBWBBBWBWBWBBBBWBW
BBWBWBWWBWWWWWBBBBWW
BBWBWWBBBWBWBBWBWWBB
WWBBWWWWBBWBWWBWBBBB
BBWBBBWBBWWWWWBBWWWB
BWBBBWBWBBWWWBWBBBBB
BWBWWWWBWBBWBWWBWWBW
WWBWWBWWWWWWWWWBBWW
BBWBWWWWBWWWWBBBBWWW
BBBBWBWWBWWWWBWBWBWB
BWBBWBBBWBBBWWBWBWWB
WBWWWWBWWBWWBBBWWWBB
WBWBBBWBWBWBBBWWBWBB
WWBWBWWWBWBWWWWBWBBB
WBWBBWBWBWBWWWWWWWBB
WWWBBWBWBBWBBBBWBWBB
WBBBWBBBWWWBWWWWB
WWWWBWWBBBBBWWBWBWWW
WWBWWBWWWBWWBBWBBBWB
WBWBBWWWWBWBWBWWWWBB
WBBBWWWBBWWBBWBBB
WBWWBWBWBWBBBBWBWWBB
WBBBBWWWWWBWWWBWWBWW
BWBWBWWWWBWWWBWWBWBB
WWBBBBWWWWBBBWWBWBWW
BWBBBBBWBBBBBBWBWWWW
BWBBBWWBBBWBWBWWWWBB
BBWBBWBWBWBBBBBWWBBB
BBBBWWBBBWWBWWBBWWBB
WWBWWBBBWBWWBWBWWWWW
WWBWBBWBBBWBBWWWBWBW
BWWWWWWWBWBBWBBBBWBB
BBBBBBBWWBBWBWWWBWWB
WWBWBWWWWBBWWBBWWBWB
WWBWBWBWBBBWWWBBBWWB
WWWBWBBBBWBBWWBBWWWB
BWWWBWBBBWWBWBBBWB
BBBWBBBBBWBWBWBBWWBB
WWBBWBBBWBBBWWBBBBWB
BBBBWWWWWBBBBBBWBWBB
WWBBWBBBWWWWBBWWW
WBBWBBBBBWBBWWWWB
BWBBBBWBWBWBWWWBBBWB
BWBWBBWWWWWWWWBBBWW
WWBBWWWBWWWWBWBWWBW
BWBBBWWBBBWWWBWBBBBB
WBBBBWWBWBWWWWWBWWBB
BWWBBWWWBBBBWWWWWBWB
BWBWBWWBWWBWBBBWBWWB

